            1111111111222222222233333333334444444444555555555566666666667777777
  01234567890123456789012345678901234567890123456789012345678901234567890123456
00........................................#########...........#########........00
01........................................#.......#...........#.......#........01
02........................................#.......#...........#.......#........02
03........................................#.......#...........#.......#........03
04........................................#.......#...........#.......#........04
05........................................#.......#...........#.......#........05
06........................................#.......#...........#.......#........06
07........................................#.......#...........#.......#........07
08........................................#.......#.......#############........08
09........................................#.......#.......#...#................09
10#########...................#############.......#.....^######................10
11#.......#...................#...................#.......#....................11
12#.......#...................#...................###########..................12
13#.......#...................#...........................#.#..................13
14#.......#...................#...........................#.#..................14
15#.......#...................#...........................#.#..................15
16#.......#...................#...........................###########..........16
17#.......#...................#.............................#.......#..........17
18###########.................#.............................###########........18
19........#.#.................#.....................................#.#........19
20........#.#...........#######.....................................#.#........20
21........#.#...........#...........................................#.#........21
22........###########...#...........................................###########22
23..........#.......#...#.............................................#.......#23
24..........###########.#.............................................#.......#24
25..................#.#.#.............................................#.......#25
26..................#.#.#.............................................#.......#26
27..................#.#.#.............................................#.......#27
28..................###########.......................................#.......#28
29....................#.#.............................................#.......#29
30................#######.............................................#########30
31................#...#........................................................31
32........#############........................................................32
33........#.......#............................................................33
34........#.......#............................................................34
35........#.......#............................................................35
36........#.......#............................................................36
37........#.......#............................................................37
38........#.......#............................................................38
39........#.......#............................................................39
40........#########............................................................40
  00000000001111111111222222222233333333334444444444555555555566666666667777777
  01234567890123456789012345678901234567890123456789012345678901234567890123456


